

20202020202020202020202020
24242424242424242424242424
26262626262626262626262626
11111111111111111111111111
15151515151515151515151515
12121212121212121212121212